    #####
    #   #
    #@  #
  ###  @##
  #  @ @ #
### # ## #   ######
#   # ## #####  OO#
# @  @          OO#
##### ### #A##  OO#
    #     #########
    #######