    #####
    #   #
    #@  #
  ###  @##
  #  @ @ #
### # ## #   ######
#   # ## #####    #
# @  @            #
##### ### #A##    #
    #     #########
    #######